1111111111111111111111111111111111
1E000000000000C00000C0000000000011
1N0010100100C0010100100N0000101011
1010010010101010001001000N00010101
1P0000000C00C00000000N0000000000C1
1111111111111111001111111111111111
1111111111111111011111111111111111
10000000000000C00000C0000000000011
1N0010100100C0010100100N0000101011
1010010010101010001001000N00010101
100000000C00C00000000N0000000000C1
1111111111111111111111111111111111